%%%%%%%%%%%%%%%%%%%%%%%%%%%%%%
%P                           %
%                           .%
%%%%%%%%%%%%%%%%%%%%%%%%%%%%%%
