%%%%%%%%%%%%%%%%%%%%%%%%%%%%%%
%P                           %
%                           .%
%                            %
%                            %
%                            %
%                            %
%%%%%%%%%%%%%%%%%%%%%%%%%%%%%%
